31,28
4333333333333543333333333335
2111111111111221111111111112
2143351433351221433351433512
2820021200021221200021200282
2163371633371671633371633712
2111111111111111111111111112
2143351451433333351451433512
2163371221633543371221633712
2111111221111221111221111112
6333351263351221433721433337
0000021243371671633521200000
0000021221111111111221200000
0000021221433333351221200000
3333371671200000021671633333
e11111111120000002111111111d
3333351451200000021451433333
0000021221633333371221200000
0000021221111111111221200000
0000021221433333351221200000
4333371671633543371671633335
2111111111111221111111111112
2143351433351221433351433512
2163521633371671633371243712
2811221111111011111111221182
6351221451433333351451221437
4371671221633543371221671635
2111111221111221111221111112
2143333763351221433763333512
2163333333371671633333333712
2111111111111111111111111112
6333333333333333333333333337
